AEEEEWEEEE
EWEEEEEEEE
EEEEEEEEEE
WEEEEWEEEE
EEEEEWEEEE
EEEEWEEEEE
EWWEEEWEEE
EEEEEEEEEE
EEEEEEEEEE
EEEEEEEEED
