EEEEEWEEEE
EWEEEWWEEE
EEEEWAWEEE
WEEEWWEEEE
EEEEEWEEEE
EEEEWEEEEE
EWWEEEWEEE
EEEEEEEEEE
EEEEEEEEEE
EEEEEEEEED